Rank,Team,GAME_CN,SBA_CN,SB_CN,CS_CN,SB_RT,RO_CN,POFF_CN
1,»ï¼º,93,124,87,37,70.2,32,9
2,Å°¿ò,96,90,76,14,84.4,27,7
3,·Ôµ¥,88,84,63,21,75.0,32,2
4,KT,90,94,62,32,66.0,35,4
5,µÎ»ê,93,84,59,25,70.2,37,1
5,NC,89,80,59,21,73.8,23,4
7,LG,94,80,52,28,65.0,47,4
8,SK,93,73,47,26,64.4,30,10
9,ÇÑÈ­,92,64,37,27,57.8,31,4
10,KIA,90,40,28,12,70.0,28,4
